█████████████████████████████
█           █           X   █
█  $        █               ⚁
█           ████████        █
█       █                   █
█       █           B       █
█   ⶆ   █                   █
█████████████████████████████