█████████████████████████████
█           █               █
█  $        █               ⚁
█           ████████        █
█       █                   █
█       █     X     B       █
█   ⶆ   █                   █
█████████████████████████████