█████████████████████████████
█           █               █
█           █               █
█           █               █
█  $        █            X  ⚁
█           ████████        █
█       █                   █
█       █           B       █
█   ⶆ   █                   █
█████████████████████████████