█████████████████████████████████████
█                                   █
ⶆ             ▟▀▀▀▀▀▙             █
█           ◀︎█         █▶          █
█           ◀︎█  ✖  ✖  █▶          █
█           ◀︎█    ▼    █▶          █
█              ▜     ▛             █
█                ▼▼▼▼               █
█                                   █
█                                   █
█████████████████████████████████████