█████████████████████████████████████
█                                   █
ⶆ             ▟▀▀▀▀▀▀▙              █
█           ◀︎█        █▶            █
█           ◀︎█  X  X  █▶            █
█           ◀︎█    ▼   █▶            █
█             ▜      ▛              █
█              ▀▼▼▼▼▀               █
█                                   █
█                                   █
█████████████████████████████████████