█████████████████████████████████████
█                           █   █►$◀︎█
ⶆ           █               █X█ █►$◀︎█
█           █               █ █ █►$◀︎█
█           ████████        █ █ █► ◀︎█
█                           █ █X█► ◀︎█
█                           █ █ █► ◀︎█
█                             █    ◀︎█
█████ ██████████████████████████   ◀︎█
█             X                    ◀︎█
█ ⛗        B    X                  ◀︎█
█             X                    ◀︎█
████████████████ ████████████████████
             █  ⛗  █
             █ $$$ █
             █     █
             ███⚂███